-,-,-,-,-,-,-,-,-,-,-,-,-,-,-,-,-,-,-,-,-,-,-,-,-,-,-,-,-,-,-,-,-,-,-,-,-,-,-,-,-,-,-,-,-,-,-,-,-,-,-,-,-,-,-,-,-,-,-,-,-,-,-,-,-,-,-,-,-,-,-,-,-,-,-,-,-,-,-,-,-,-,-,-,-,-,-,-,-,-,-,-,-,-,-,-,-,-,-,-,-,-,-,-,-,-,-,-,-,-,-,-,-,-
|, , , ,|,B, , , , , , , , , , , , , , , , , , , , , , , , , , , , , , , , , , , , , , , , , ,=,=, , , , , , , , , , , , , , , , , , , , , , , ,=,=, , , , , , , , , , , , , , , , , , , , , , , , , , , , , , , , , , , , , , , ,|
|, , , ,|,B, , , , , , , , , , , , , , , , , , , , , , , , , , , , , , , , , , , , , , , , , ,=,=, , , , , , , , , , , , , , , , , , , , , , , ,=,=, , , , , , , , , , , , , , , , , , , , , , , , , , , , , , , , , , , , , , , ,|
|, , , ,|,B, , , , , , , , , , , , , , , , , , , , , , , , , , , , , , , , , , , , , , , , , ,=,=, , , , , , , , , , , , , , , , , , , , , , , ,=,=, , , , , , , , , , , , , , , , , , , , , , , , , , , , , , , , , , , , , , , ,|
|, , , ,|,B, , , , , , , , , , , , , , , , , , , , , , , , , , , , , , , , , , , , , , , , , ,=,=, , , , , , , , , , , , , , , , , , , , , , , ,=,=, , , , , , , , , , , , , , , , , , , , , , , , , , , , , , , , , , , , , , , ,|
|, , , ,|,B, , , , , , , , , , , , , , , , , , , , , , , , , , , , , , , , , , , , , , , , , ,=,=, , , , , , , , , , , , , , , , , , , , , , , ,=,=, , , , , , , , , , , , , , , , , , , , , , , , , , , , , , , , , , , , , , , ,|
|, , , ,|,B, , , , , , , , , , , , , , , , , , , , , , , , , , , , , , , , , , , , , , , , , ,=,=, , , , , , , , , , , , , , , , , , , , , , , ,=,=, , , , , , , , , , , , , , , , , , , , , , , , , , , , , , , , , , , , , , , ,|
|, , , ,|,B, , , , , , , , , , , , , , , , , , , , , , , , , , , , , , , , , , , , , , , , , ,=,=, , , , , , , , , , , , , , , , , , , , , , , ,=,=, , , , , , , , , , , , , , , , , , , , , , , , , , , , , , , , , , , , , , , ,|
|, , , ,|,B, , , , , , , , , , , , , , , , , , , , , , , , , , , , , , , , , , , , , , , , , ,=,=, , , , , , , , , , , , , , , , , , , , , , , ,=,=, , , , , , , , , , , , , , , , , , , , , , , , , , , , , , , , , , , , , , , ,|
|, , , ,|,B, , , , , , , , , , , , , , , , , , , , , , , , , , , , , , , , , , , , , , , , , ,=,=, , , , , , , , , , , , , , , , , , , , , , , ,=,=, , , , , , , , , , , , , , , , , , , , , , , , , , , , , , , , , , , , , , , ,|
|, , , ,|,B, , , , , , , , , , , , , , , , , , , , , , , , , , , , , , , , , , , , , , , , , ,=,=, , , , , , , , , , , , , , , , , , , , , , , ,=,=, , , , , , , , , , , , , , , , , , , , , , , , , , , , , , , , , , , , , , , ,|
|, , , ,|,B, , , , , , , , , , , , , , , , , , , , , , , , , , , , , , , , , , , , , , , , , ,=,=, , , , , , , , , , , , , , , , , , , , , , , ,=,=, , , , , , , , , , , , , , , , , , , , , , , , , , , , , , , , , , , , , , , ,|
|, , , ,|,B, , , , , , , , , , , , , , , , , , , , , , , , , , , , , , , , , , , , , , , , , ,=,=, , , , , , , , , , , , , , , , , , , , , , , ,=,=, , , , , , , , , , , , , , , , , , , , , , , , , , , , , , , , , , , , , , , ,|
|, , , ,|,B, , , , , , , , , , , , , , , , , , , , , , , , , , , , , , , , , , , , , , , , , ,=,=, , , , , , , , , , , , , , , , , , , , , , , ,=,=, , , , , , , , , , , , , , , , , , , , , , , , , , , , , , , , , , , , , , , ,|
|, , , ,|,B, , , , , , , , , , , , , , , , , , , , , , , , , , , , , , , , , , , , , , , , , ,=,=, , , , , , , , , , , , , , , , , , , , , , , ,=,=, , , , , , , , , , , , , , , , , , , , , , , , , , , , , , , , , , , , , , , ,|
|, , , ,|,B, , , , , , ,=,=,=,=,=,=,=,=,=,=,=,=,=,=,=,=,=,=,=,=,=,=,=,=,=,=,=,=,=,=,=,=,=,=,=,=,=, , , , , , , , , , , , , , , , , , , , , , , ,=,=,=,=,=,=,=,=,=,=,=,=,=,=,=,=,=,=,=,=,=,=,=,=,=,=,=,=,=,=,=,=,=,=,=,=,=,=,=,=,=,|
|, , , ,|,B, , , , , , , , , , , , , , , , , , , , , , , , , , , , , , , , , , , , , , , , , , , , , , , , , , , , , , , , , , , , , , , , , , , , , , , , , , , , , , , , , , , , , , , , , , , , , , , , , , , , , , , , , , , ,|
|, , , ,|,B, , , , , , , , , , , , , , , , , , , , , , , , , , , , , , , , , , , , , , , , , , , , , , , , , , , , , , , , , , , , , , , , , , , , , , , , , , , , , , , , , , , , , , , , , , , , , , , , , , , , , , , , , , , ,|
|, , , ,|,B, , , , , , , , , , , , , , , , , , , , , , , , , , , , , , , , , , , , , , , , , , , , , , , , , , , , , , , , , , , , , , , , , , , , , , , , , , , , , , , , , , , , , , , , , , , , , , , , , , , , , , , , , , , ,|
|, ,P, ,|,B, , , , , , , , , , , , , , , , , , , , , , , , , , , , , , , , , , , , , , , , , , , , , , , , , , , , , , , , , , , , , , , , , , , , , , , , , , , , , , , , , , , , , , , , , , , , , , , , , , , , , , , , , , , ,|
|, , , ,|,B, , , , , , , , , , , , , , , , , , , , , , , , , , , , , , , , , , , , , , , , , , , , , , ,V, , , , , , , , , , , , , ,V, , , , , , , , , , , , , , , , , , , , , , , , , , , , , , , , , , , , , , , , , , , , ,E, ,|
|, , , ,|,B, , , , , , , , , , , , , , , , , , , , , , , , , , , , , , , , , , , , , , , , , , , , , , , , , , , , , , , , , , , , , , , , , , , , , , , , , , , , , , , , , , , , , , , , , , , , , , , , , , , , , , , , , , , ,|
|, , , ,|,B, , , , , , , , , , , , , , , , , , , , , , , , , , , , , , , , , , , , , , , , , , , , , , , , , , , , , , , , , , , , , , , , , , , , , , , , , , , , , , , , , , , , , , , , , , , , , , , , , , , , , , , , , , , ,|
|, , , ,|,B, , , , , , , , , , , , , , , , , , , , , , , , , , , , , , , , , , , , , , , , , , , , , , , , , , , , , , , , , , , , , , , , , , , , , , , , , , , , , , , , , , , , , , , , , , , , , , , , , , , , , , , , , , , ,|
|, , , ,|,B, , , , , , ,=,=,=,=,=,=,=,=,=,=,=,=,=,=,=,=,=,=,=,=,=,=,=,=,=,=,=,=,=,=,=,=,=,=,=,=,=, , , , , , , , , , , , , , , , , , , , , , , ,=,=,=,=,=,=,=,=,=,=,=,=,=,=,=,=,=,=,=,=,=,=,=,=,=,=,=,=,=,=,=,=,=,=,=,=,=,=,=,=,=,|
|, , , ,|,B, , , , , , , , , , , , , , , , , , , , , , , , , , , , , , , , , , , , , , , , , ,=,=, , , , , , , , , , , , , , , , , , , , , , , ,=,=, , , , , , , , , , , , , , , , , , , , , , , , , , , , , , , , , , , , , , , ,|
|, , , ,|,B, , , , , , , , , , , , , , , , , , , , , , , , , , , , , , , , , , , , , , , , , ,=,=, , , , , , , , , , , , , , , , , , , , , , , ,=,=, , , , , , , , , , , , , , , , , , , , , , , , , , , , , , , , , , , , , , , ,|
|, , , ,|,B, , , , , , , , , , , , , , , , , , , , , , , , , , , , , , , , , , , , , , , , , ,=,=, , , , , , , , , , , , , , , , , , , , , , , ,=,=, , , , , , , , , , , , , , , , , , , , , , , , , , , , , , , , , , , , , , , ,|
|, , , ,|,B, , , , , , , , , , , , , , , , , , , , , , , , , , , , , , , , , , , , , , , , , ,=,=, , , , , , , , , , , , , , , , , , , , , , , ,=,=, , , , , , , , , , , , , , , , , , , , , , , , , , , , , , , , , , , , , , , ,|
|, , , ,|,B, , , , , , , , , , , , , , , , , , , , , , , , , , , , , , , , , , , , , , , , , ,=,=, , , , , , , , , , , , , , , , , , , , , , , ,=,=, , , , , , , , , , , , , , , , , , , , , , , , , , , , , , , , , , , , , , , ,|
|, , , ,|,B, , , , , , , , , , , , , , , , , , , , , , , , , , , , , , , , , , , , , , , , , ,=,=, , , , , , , , , , , , , , , , , , , , , , , ,=,=, , , , , , , , , , , , , , , , , , , , , , , , , , , , , , , , , , , , , , , ,|
|, , , ,|,B, , , , , , , , , , , , , , , , , , , , , , , , , , , , , , , , , , , , , , , , , ,=,=, , , , , , , , , , , , , , , , , , , , , , , ,=,=, , , , , , , , , , , , , , , , , , , , , , , , , , , , , , , , , , , , , , , ,|
|, , , ,|,B, , , , , , , , , , , , , , , , , , , , , , , , , , , , , , , , , , , , , , , , , ,=,=, , , , , , , , , , , , , , , , , , , , , , , ,=,=, , , , , , , , , , , , , , , , , , , , , , , , , , , , , , , , , , , , , , , ,|
|, , , ,|,B,B,B,B,B,B,B,B,B,B,B,B,B,B,B,B,B,B,B,B,B,B,B,B,B,B,B,B,B,B,B,B,B,B,B,B,B,B,B,B,B,B,B,B,B,B,B,B,B,B,B,B,B,B,B,B,B,B,B,B,B,B,B,B,B,B,B,B,B,B,B,B,B,B,B,B,B,B,B,B,B,B,B,B,B,B,B,B,B,B,B,B,B,B,B,B,B,B,B,B,B,B,B,B,B,B,B,B,|
|, , , ,|,-,-,-,-,-,-,-,-,-,-,-,-,-,-,-,-,-,-,-,-,-,-,-,-,-,-,-,-,-,-,-,-,-,-,-,-,-,-,-,-,-,-,-,-,-,-,-,-,-,-,-,-,-,-,-,-,-,-,-,-,-,-,-,-,-,-,-,-,-,-,-,-,-,-,-,-,-,-,-,-,-,-,-,-,-,-,-,-,-,-,-,-,-,-,-,-,-,-,-,-,-,-,-,-,-,-,-,-,|
|, , , ,|, , , , , , , , , , , , , , , , , , , , , , , , , , , , , , , , , , , , , , , , , , , , , , , , , , , , , , , , , , , , , , , , , , , , , , , , , , , , , , , , , , , , , , , , , , , , , , , , , , , , , , , , , , , , ,|
|, , , ,|, , , , , , , , , , , , , , , , , , , , , , , , , , , , , , , , , , , , , , , , , , , , , , , , , , , , , , , , , , , , , , , , , , , , , , , , , , , , , , , , , , , , , , , , , , , , , , , , , , , , , , , , , , , , ,|
|, , , ,|, , , , , , , ,D, , , , , , , , , , , , , , , , , , , , , , , , , , , , , , , , , , , , , , , , , , , , , , , , , , , , , , , , , , , , , , , , , , , , , , , , , , , , , , , , , , , , , , , , , , , , , , , , , , , , ,|
|, , , ,|, , , , , , , , , , , , , , , , , , , , , , , , , , , , , , , , , , , , , , , , , , , , , , , , , , , , , , , , , , , , , , , , , , , , , , , , , , , , , , , , , , , , , , , , , , , , , , , , , , , , , , , , , , , , ,|
-,-,-,-,-,-,-,-,-,-,-,-,-,-,-,-,-,-,-,-,-,-,-,-,-,-,-,-,-,-,-,-,-,-,-,-,-,-,-,-,-,-,-,-,-,-,-,-,-,-,-,-,-,-,-,-,-,-,-,-,-,-,-,-,-,-,-,-,-,-,-,-,-,-,-,-,-,-,-,-,-,-,-,-,-,-,-,-,-,-,-,-,-,-,-,-,-,-,-,-,-,-,-,-,-,-,-,-,-,-,-,-,-,-
