==========================================================================================
|                                                                                        |
|                                                                                        |
|                                                                                        |
|                                                                                        |
|                                                                                        |
|                                                                                        |
|                                                                                        |
|            ********                                                                    |
|            ********                                                                    |
|            ********                                                                    |
|            ********                                                                    |
|            ********                                                                    |
|            ********                                                                    |
|            ********                                                                    |
|            ********                                                                    |
|                                                                                        |
|                                                                                        |
==========================================================================================